<GRAPHION><CONDENOF><PROPOROF><DRAFTON><NEGRAON><DOBGOLON><ELITE><DOBANCON><DOBALTON>
          PREMATRICULA.CODIGO:(CODIGO)<DOBANCOF><DOBALTOF>
                                  PARA EL GRADO (NIVEL)

 Los campos antes del = deben ir en parentesis en el formato a dise¤ar

 Para definir la longitud del contenido de los campos, despu‚s del nombre del campo
 se debe agreagar el numero en dos digitos de los caracteres que se desean trurncar
 Ejemplo:
 cApelliEst20 => 20 Caracteres de longitud
 cApelliEst00 => Elimina los Espacios en Blanco

 ESTUDIANTE = (ESTUDIANTE)
 CODIGO = (CODIGO)
 GRUPO = (GRUPO)
 GRADO = (GRADO)
 NIVEL = (NIVEL)
 cApelliEst = (cApelliEst)
 cNombreEst = (cNombreEst)
 cApelliEst = (cApelliEst)05
 cNombreEst = (cApelliEst)00 (cNombreEst)
 dFecNacEst = (dFecNacEst)
 cLugNacEst = (cLugNacEst)
 cDocNitEst = (cDocNitEst)
 cLugNitEst = (cLugNitEst)
 cTipNitEst = (cTipNitEst)
 lFotNitEst = (lFotNitEst)
 lSexFemEst = (lSexFemEst)
 cDireccEst = (cDireccEst)
 cBarrioEst = (cBarrioEst)
 cCiudadEst = (cCiudadEst)
 cTelefnEst = (cTelefnEst)
 cTelCelEst = (cTelCelEst)
 cMaiEstEst = (cMaiEstEst)
 cParNitEst = (cParNitEst)
 cNomEpsEst = (cNomEpsEst)
 cGrupRhEst = (cGrupRhEst)
 cNitCo1Est = (cNitCo1Est)
 cTipCo1Est = (cTipCo1Est)
 lNoRCo1Est = (lNoRCo1Est)
 cNitCo2Est = (cNitCo2Est)
 cTipCo2Est = (cTipCo2Est)
 lNoRCo2Est = (lNoRCo2Est)
 cNitCo3Est = (cNitCo3Est)
 cTipCo3Est = (cTipCo3Est)
 lNoRCo3Est = (lNoRCo3Est)
 cNitCo4Est = (cNitCo4Est)
 cTipCo4Est = (cTipCo4Est)
 lNoRCo4Est = (lNoRCo4Est)
 cApePadEst = (cApePadEst)
 cNomPadEst = (cNomPadEst)
 lPadQepEst = (lPadQepEst)
 dNacPadEst = (dNacPadEst)
 cLugPadEst = (cLugPadEst)
 cPadNitEst = (cPadNitEst)
 cPadLugEst = (cPadLugEst)
 cPadTntEst = (cPadTntEst)
 lPadFotEst = (lPadFotEst)
 cProPadEst = (cProPadEst)
 cEmpPadEst = (cEmpPadEst)
 cCarPadEst = (cCarPadEst)
 cDirPadEst = (cDirPadEst)
 cBarPadEst = (cBarPadEst)
 cCiuPadEst = (cCiuPadEst)
 cTelPadEst = (cTelPadEst)
 cCelPadEst = (cCelPadEst)
 cFaxPadEst = (cFaxPadEst)
 cBipPadEst = (cBipPadEst)
 cMaiPadEst = (cMaiPadEst)
 cApeMadEst = (cApeMadEst)
 cNomMadEst = (cNomMadEst)
 lMadQepEst = (lMadQepEst)
 dNacMadEst = (dNacMadEst)
 cLugMadEst = (cLugMadEst)
 cMadNitEst = (cMadNitEst)
 cMadLugEst = (cMadLugEst)
 cMadTntEst = (cMadTntEst)
 lMadFotEst = (lMadFotEst)
 cProMadEst = (cProMadEst)
 cEmpMadEst = (cEmpMadEst)
 cCarMadEst = (cCarMadEst)
 cDirMadEst = (cDirMadEst)
 cBarMadEst = (cBarMadEst)
 cCiuMadEst = (cCiuMadEst)
 cTelMadEst = (cTelMadEst)
 cCelMadEst = (cCelMadEst)
 cFaxMadEst = (cFaxMadEst)
 cBipMadEst = (cBipMadEst)
 cMaiMadEst = (cMaiMadEst)
 cApeAcuEst = (cApeAcuEst)
 cNomAcuEst = (cNomAcuEst)
 lAcuQepEst = (lAcuQepEst)
 dNacAcuEst = (dNacAcuEst)
 cLugAcuEst = (cLugAcuEst)
 cAcuNitEst = (cAcuNitEst)
 cAcuLugEst = (cAcuLugEst)
 cAcuTntEst = (cAcuTntEst)
 lAcuFotEst = (lAcuFotEst)
 cProAcuEst = (cProAcuEst)
 cEmpAcuEst = (cEmpAcuEst)
 cCarAcuEst = (cCarAcuEst)
 cDirAcuEst = (cDirAcuEst)
 cBarAcuEst = (cBarAcuEst)
 cCiuAcuEst = (cCiuAcuEst)
 cTe1AcuEst = (cTe1AcuEst)
 cTe2AcuEst = (cTe2AcuEst)
 cCelAcuEst = (cCelAcuEst)
 cFaxAcuEst = (cFaxAcuEst)
 cBipAcuEst = (cBipAcuEst)
 cMaiAcuEst = (cMaiAcuEst)
 cParAcuEst = (cParAcuEst)
